1111111111111111111111111111111111
1E0000000000000C00000C000C00000001
1010010100100000101001000000010101
1010010010101010001001000111010101
1P0000000C00C000000000C001C10000C1
1111111111111111111111111111111111
