1111111111111111111111111111111111
1E0000000000000C00000C000C00000001
1010010100100000101001000000010101
1010010010101010001001000C00010101
1P0000000C00C000000000C000C00000C1
100000000000000C00000C000C00000001
1010010100100000101001000000010101
1010010010101010001001000C00010101
100000000C00C000000000C000C00000C1
1111111111111111111111111111111111